<Government_of_Canada>	<RCAF_Station_Grostenquin>	<owns>
<Szymon_Bogumił_Zug>	<Lelewel_Palace>	<created>
<EA_Canada>	<2010_FIFA_World_Cup_South_Africa_(video_game)>	<created>
<Gary_D._Solis>	<Cambridge_University_Press>	<created>
<Frances_Howard_(actress)>	<Samuel_Goldwyn>	<isMarriedTo>
<Fun_Labs>	<Cabela's_Dangerous_Hunts_2009>	<created>
<Zhang_Jindong>	<Suning_Holdings_Group>	<owns>
<Carly_Chaikin>	<Suburgatory>	<created>
<Florence_Engel_Randall>	<A_Watcher_in_the_Woods>	<created>
<Hilary_Beckles>	<University_of_the_West_Indies>	<worksAt>
<Gavriel_Salvendy>	<Tsinghua_University>	<worksAt>
<Tom_Gale>	<Dodge_Viper>	<created>
<Leo_Butler>	<Redundant_(play)>	<created>
<David_Turashvili>	<Flight_from_the_USSR>	<created>
<John_Okell>	<SOAS,_University_of_London>	<worksAt>
<Lenovo>	<Lenovo_IdeaPad_S12>	<created>
<Marsilio_Ficino>	<De_vita_libri_tres>	<created>
<Han_Han>	<Triple_Door_(novel)>	<created>
<Southern_Region_of_British_Railways>	<Godshill_railway_station>	<owns>
<Defy_Media>	<Shut_Up!_Cartoons>	<owns>
<Robert_Townsend_(actor)>	<The_Parent_'Hood>	<created>
<Horton_Foote>	<To_Kill_a_Mockingbird_(film)>	<created>
<Aristophanes>	<The_Frogs>	<created>
<Martha_Graham>	<Presidential_Medal_of_Freedom>	<hasWonPrize>
<Samuel_Hoffenstein>	<Enchanted_April_(1935_film)>	<created>
<Lorna_Gray>	<Sherman_Oaks,_Los_Angeles>	<diedIn>
<Hungary>	<MVM_Group>	<owns>
<James_Barnet>	<Chief_Secretary's_building>	<created>
<Ludwig_Bemelmans>	<Madeline>	<created>
<Brendan_I._Koerner>	<Now_the_Hell_Will_Start>	<created>
<The_Shubert_Organization>	<Lafayette_Square_Opera_House>	<owns>
<Crystal_Dynamics>	<Legacy_of_Kain>	<created>
<Juerg_Neuenschwander>	<Milky_Way>	<created>
<Glasgow_City_Council>	<King's_Theatre,_Glasgow>	<owns>
<Huron_Broadcasting>	<CKCY_(AM)>	<owns>
<Adelphia_Communications_Corporation>	<Orange_County_Newschannel>	<owns>
<Angus_MacPhail>	<Aventure_Malgache>	<created>
<Marcus_Miller>	<Da_Butt>	<created>
<Cork_Distilleries_Company>	<Jameson_Experience,_Midleton>	<owns>
<Thomas_Nagel>	<The_View_From_Nowhere>	<created>
<Archduchess_Yolande_of_Austria>	<Archduke_Carl_Ludwig_of_Austria_(1918–2007)>	<isMarriedTo>
<Paul_Danquah>	<A_Taste_of_Honey_(film)>	<created>
<Vasyl_Krychevsky>	<Coat_of_arms_of_Ukraine>	<created>
<Karl_von_Vincent>	<Order_of_Saint_Stephen_of_Hungary>	<hasWonPrize>
<Haruki_Murakami>	<Norwegian_Wood_(novel)>	<created>
<Sashadhar_Mukherjee>	<Dil_Deke_Dekho>	<created>
<Scott_Moore_(screenwriter)>	<The_Change-Up>	<created>
<Donald_Antrim>	<The_Verificationist>	<created>
<LucasArts>	<Monkey_Island_(series)>	<created>
<George_FitzRoy,_4th_Duke_of_Grafton>	<Waxy_(horse)>	<owns>
<Levan_Koguashvili>	<Blind_Dates>	<created>
<BBC>	<Television_Centre,_London>	<owns>
<Christopher_Guest>	<Jamie_Lee_Curtis>	<isMarriedTo>
<Tony_Warren>	<Coronation_Street>	<created>
<USFR_Media_Group>	<America_One>	<owns>
<Richard_Clipston_Sturgis>	<Massachusetts_State_House>	<created>
<William_Blum>	<Killing_Hope>	<created>
<UniCredit>	<Banco_di_Sicilia>	<owns>
<Ride_&_Show_Engineering,_Inc.>	<Jaws_(ride)>	<created>
<Ambrose_McGuirk>	<Milwaukee_Badgers>	<owns>
<Eero_Saarinen>	<Swedish_Theatre>	<created>
<Roland_Rainer>	<ÖVB_Arena>	<created>
<Katrin_Cartlidge>	<Career_Girls>	<created>
<Arts_Council_of_Great_Britain>	<Royal_Festival_Hall>	<owns>
<Shōhei_Ōoka>	<Fires_on_the_Plain_(novel)>	<created>
<Emily_H._Vokes>	<Tulane_University>	<worksAt>
<J._B._Gunn>	<Cairo>	<wasBornIn>
<Erwin_Chemerinsky>	<Duke_University_School_of_Law>	<worksAt>
<Deborah_Walley>	<John_Ashley_(actor)>	<isMarriedTo>
<Houston_Astros>	<Buffalo_Stadium>	<owns>
<Ilo_Mitkë_Qafëzezi>	<New_Academy_(Moscopole)>	<created>
<Alan_Beddoe>	<Books_of_Remembrance_(Canada)>	<created>
<William_Brinkley>	<Don't_Go_Near_the_Water_(novel)>	<created>
<Aston_Webb>	<London>	<wasBornIn>
<Edward_L._Hart>	<Hymns_of_The_Church_of_Jesus_Christ_of_Latter-day_Saints_(1985_book)>	<created>
<Michael_Heisley>	<Vancouver_Grizzlies>	<owns>
<Government_of_India>	<Rail_Wheel_Factory>	<owns>
<Willis_Hall>	<Billy_Liar>	<created>
<Danielle_Feinberg>	<Brave_(2012_film)>	<created>
<Bobby_Driscoll>	<Song_of_the_South>	<created>
<Studio_100>	<Junior_(TV_channel)>	<owns>
<Gene_V._Glass>	<San_Jose_State_University>	<worksAt>
<Elizabeth_Bowen>	<The_House_in_Paris>	<created>
<Howard_Hughes>	<Houston>	<diedIn>
<Claus_Luthe>	<BMW_5_Series_(E34)>	<created>
<Storm_de_Hirsch>	<Goodbye_in_the_Mirror>	<created>
<Geraldine_Page>	<The_Trip_to_Bountiful>	<created>
<Rajiv_Malhotra>	<Breaking_India>	<created>
<Donovan_Leitch_(actor)>	<Kirsty_Hume>	<isMarriedTo>
<Pennsylvania_Railroad>	<Mon_Line>	<owns>
<Michael_Stewart_(playwright)>	<George_M!>	<created>
<Shekhar_Kapur>	<Suchitra_Krishnamoorthi>	<isMarriedTo>
<Reg_Grundy_Organisation>	<Atinale_Al_Precio>	<created>
<Paul_Harding_(author)>	<Tinkers_(novel)>	<created>
<Chōjun_Miyagi>	<Gōjū-ryū>	<created>
<Steven_Levitsky>	<Harvard_University>	<worksAt>
<Radio_New_Zealand>	<Radio_Nelson>	<owns>
<Arne_Henriksen>	<Skøyen_Station>	<created>
<James_Goldman>	<The_Lion_in_Winter_(2003_film)>	<created>
<Lew_Wallace>	<Whig_Party_(United_States)>	<isAffiliatedTo>
<Robert_Lešnik>	<Mercedes-Benz_S-Class_(W222)>	<created>
